11111111111111111111111111111111111111111111111111111111111111111111111111111111111111111111111111111111111111111111111111111111
11111111111111111111111111111111111111111111111111111111111111111111111111111111111111111111111111111111111111111111111111111111
11111111111111111111111111111111111111111111111111111111111111111111111111111111111111111111111111111111111111111111111111111111
11111111111111111111111111111111111111111111111111111111111111111111111111111111111111111111111111111111111111111111111111111111
11111111111111111111111111111111111111111111111111111111111111111111111111111111111111111111111111111111111111111111111111111111
11111111111111111111111111111111111111111111111111111111111111111111111111111111111111111111111111111111111111111111111111111111
11111111111111111111111111111111111111111111111111111111111111111111111111111111111111111111111111111111111111111111111111111111
11111111111111111111111111111111111111111111111111111111111111111111111111111111111111111111111111111111111111111111111111111111
11111111111111111111111111111111111111111111111111111111111111111111111111111111111111111111111111111111111111111111111111111111
11111111111111111111111111111111111111111111111111111111111111111111111111111111111111111111111111111111111111111111111111111111
11111111111111111111111111111111111111111111111111111111111111111111111111111111111111111111111111111111111111111111111111111111
11111112222220000000000000000000011111111111111111111111111111111111111111111111111111000000000000000000000000000000000011111111
11111112222220000000000000000000011111111111111111111111111111111111111111111111111111000000000000000000000000000000000011111111
11111112222220000000000000000000011111111111111111111111111111111111111111111111111111000000000000000000000000000000000011111111
11111112222220000000000000000000011111111111111111111111111111111111111111111111111111000000000000000000000000000000000011111111
11111112222220000000000000000000011111111111111111111111111111111111111111111111111111000000000000000000000000000000000011111111
11111112222220000000000000000000011111111111111111111111111111111111111111111111111111000000000000000000000000000000000011111111
11111112222220000000000000000000011111111111111111111111111111111111111111111111111111000000000000000000000000000000000011111111
11111112222220000000000000000000011111111111111111111111111111111111111111111111111111000000000000000000000000000000000011111111
11111112222220000000000000000000011111111111111111111111111111111111111111111111111111000000000000000000000000000000000011111111
11111112222220000000000000000000011111111111111111111111111111111111111111111111111111000000000000000000000000000000000011111111
11111112222221111111111111111111111111111111111111111111111111111111111111111111111111111111111111111111111111111111111111111111
11111112222221111111111111111111111111111111111111111111111111111111111111111111111111111111111111111111111111111111111111111111
11111112222221111111111111111111111111111111111111111111111111111111111111111111111111111111111111111111111111111111111111111111
11111112222221111111111111111111111111111111111111111111111111111111111111111111111111111111111111111111111111111111111111111111
11111112222221111111111111111111111111111111111111111111111111111111111111111111111111111111111111111111111111111111111111111111
11111112222221111111111111111111111111111111111111111111111111111111111111111111111111111111111111111111111111111111111111111111
11111112222221111111111111111111111111111111111111111111111111111111111111111111111111111111111111111111111111111111111111111111
11111112222221111111111111111111111111111111111111111111111111111111111111111111111111111111111111111111111111111111111111111111
11111112222221111111111111111111111111111111111111111111111111111111111111111111111111111111111111111111111111111111111111111111
11111112222221111111111111111111111111111111111111111111111111111111111111111111111111111111111111111111111111111111111111111111
11111112222221111111111111111111111111111111111111111111111111111111111111111111111111111111111111111111111111111111111111111111
11111112222221111111111111111111111111111111111111111111111111111111111111111111111111111111111111111111111111111111111111111111
11111112222221111111111111111111111111111111111111111111111111111111111111111111111111111111111111111111111111111111111111111111
11111112222222000000000000000000000000000000000000000000000000000000000000000000000000111111111111111111111111111111111111111111
11111112222222000000000000000000000000000000000000000000000000000000000000000000000000111111111111111111111111111111111111111111
11111112222222000000000000000000000000000000000000000000000000000000000000000000000000111111111111111111111111111111111111111111
11111112222222000000000000000000000000000000000000000000000000000000000000000000000000111111111111111111111111111111111111111111
11111112222222000000000000000000000000000000000000000000000000000000000000000000000000111111111111111111111111111111111111111111
11111112222222000000000000000000000000000000000000000000000000000000000000000000000000111111111111111111111111111111111111111111
11111112222222111111111111111111111111111111111111111111111111111111111111111111111111111111111111111111111111111111111111111111
11111112222222111111111111111111111111111111111111111111111111111111111111111111111111111111111111111111111111111111111111111111
11111112222222111111111111111111111111111111111111111111111111111111111111111111111111111111111111111111111111111111111111111111
11111112222222111111111111111111111111111111111111111111111111111111111111111111111111111111111111111111111111111111111111111111
11111112222222111111111111111111111111111111111111111111111111111111111111111111111111111111111111111111111111111111111111111111
11111112222222111111111111111111111111111111111111111111111111111111111111111111111111111111111111111111111111111111111111111111
11111112222222111111111111111111111111111111111111111111111111111111111111111111111111111111111111111111111111111111111111111111
11111112222222111111111111111111111111111111111111111111111111111111111111111111111111111111111111111111111111111111111111111111
11111112222222111111111111111111111111111111111111111111111111111111111111111111111111111111111111111111111111111111111111111111
11111112222222111111111111111111111111111111111111111111111111111111111111111111111111111111111111111111111111111111111111111111
11111112222222111111111111111111111111111111111111111111111111111111111111111111111111111111111111111111111111111111111111111111
11111112222222111111111111111111111111111111111111111111111111111111111111111111111111111111111111111111111111111111111111111111
11111112222222111111111111111111111111111111111111111111111111111111111111111111111111111111111111111111111111111111111111111111
11111112222222111111111111111111111111111111111111111111111111111111111111111111111111111111111111111111111111111111111111111111
11111112222222111111111111111111111111111111111111111111111111111111111111111111111111111111111111111111111111111111111111111111
11111112200000000000000000000000000000000000000000000000000000000000000000000000000000111111111111111111111111111111111111111111
11111112200000000000000000000000000000000000000000000000000000000000000000000000000000111111111111111111111111111111111111111111
11111112200000000000000000000000000000000000000000000000000000000000000000000000000000111111111111111111111111111111111111111111
11111112200000000000000000000000000000000000000000000000000000000000000000000000000000111111111111111111111111111111111111111111
11111112200000000000000000000000000000000000000000000000000000000000000000000000000000111111111111111111111111111111111111111111
11111112200000000000000000000000000000000000000000000000000000000000000000000000000000111111111111111111111111111111111111111111
11111112211111111111111111111111111111111111111111111111111111111111111111111111111111111111111111111111111111111111111111111111
11111112211111111111111111111111111111111111111111111111111111111111111111111111111111111111111111111111111111111111111111111111
11111112211111111111111111111111111111111111111111111111111111111111111111111111111111111111111111111111111111111111111111111111
11111112211111111111111111111111111111111111111111111111111111111111111111111111111111111111111111111111111111111111111111111111
11111112211111111111111111111111111111111111111111111111111111111111111111111111111111111111111111111111111111111111111111111111
11111112211111111111111111111111111111111111111111111111111111111111111111111111111111111111111111111111111111111111111111111111
11111112211111111111111111111111111111111111111111111111111111111111111111111111111111111111111111111111111111111111111111111111
11111112211111111111111111111111111111111111111111111111111111111111111111111111111111111111111111111111111111111111111111111111
11111112211111111111111111111111111111111111111111111111111111111111111111111111111111111111111111111111111111111111111111111111
11111112211111111111111111111111111111111111111111111111111111111111111111111111111111111111111111111111111111111111111111111111
11111112211111111111111111111111111111111111111111111111111111111111111111111111111111111111111111111111111111111111111111111111
11111112211111111111111111111111111111111111111111111111111111111111111111111111111111111111111111111111111111111111111111111111
11111112211111111111111111111111111111111111111111111111111111111111111111111111111111111111111111111111111111111111111111111111
11111112222222222222222222222222222222222222222222222222222222222222221111111111111111111111111111111111111111111111111111111111
11111112222222222222222222222222220000000000000000000000011111111111112000000000000000000000000000000000001111111111111111111111
11111112222222222222222222222222220000000000000000000000011111111111112000000000000000000000000000000000001111111111111111111111
11111112222222222222222222222222220000000000000000000000011111111111112000000000000000000000000000000000001111111111111111111111
11111112222222222222222222222222220000000000000000000000011111111111112000000000000000000000000000000000001111111111111111111111
11111112222222222222222222222222220000000000000000000000011111111111112000000000000000000000000000000000001111111111111111111111
11111112222222222222222222222222220000000000000000000000011111111111112000000000000000000000000000000000001111111111111111111111
11111112222222222222222222222222220000000000000000000000011111111111112000000000000000000000000000000000001111111111111111111111
11111112222222222222222222222222220000000000000000000000011111111111112000000000000000000000000000000000001111111111111111111111
11111112222222222222222222222222220000000000000000000000011111111111112000000000000000000000000000000000001111111111111111111111
11111112222222222222222222222222220000000000000000000000011111111111112000000000000000000000000000000000001111111111111111111111
11111112222222222222222222222222220000000000000000000000011111111111112111111111111111111111111111111111111111111111111111111111
11111112222222222222222222222222220000000000000000000000011111111111112111111111111111111111111111111111111111111111111111111111
11111112222222222222222222222222220000000000000000000000011111111111112111111111111111111111111111111111111111111111111111111111
11111112222222222222222222222222220000000000000000000000011111111111112111111111111111111111111111111111111111111111111111111111
11111112222222222222222222222222220000000000000000000000011111111111112111111111111111111111111111111111111111111111111111111111
11111110000000000000000111111111110000000000000000000000011111111111112111111111111111111111111111111111111111111111111111111111
11111110000000000000000111111111110000000000000000000000011111111111112111111111111111111111111111111111111111111111111111111111
11111110000000000000000111111111110000000000000000000000011111111111112111111111111111111111111111111111111111111111111111111111
11111110000000000000000111111111110000000000000000000000011111111111112111111111111111111111111111111111111111111111111111111111
11111110000000000000000111111111110000000000000000000000011111111111112111111111111111111111111111111111111111111111111111111111
11111110000000000000000111111111110000000000000000000000011111111111112111111111111111111111111111111111111111111111111111111111
11111110000000000000000111111111110000000000000000000000011111111111112111111111111111111111111111111111111111111111111111111111
11111110000000000000000111111111110000000000000000000000011111111111112111111111111111111111111111111111111111111111111111111111
11111110000000000000000111111111110000000000000000000000011111111111112111111111111111111111111111111111111111111111111111111111
11111110000000000000000111111111110000000000000000000000011111111111112111111111111111111111111111111111111111111111111111111111
11111110000000000000000111111111110000000000000000000000011111111111112111111111111111111111111111111111111111111111111111111111
11111110000000000000000111111111110000000000000000000000011111111111112111111111111111111111111111111111111111111111111111111111
11111110000000000000000111111111110000000000000000000000011111111111112111111111111111111111111111111111111111111111111111111111
11111110000000000000000111111111110000000000000000000000011111111111112111111111111111111111111111111111111111111111111111111111
11111110000000000000000111111111110000000000000000000000011111111111112111111111111111111111111111111111111111111111111111111111
11111110000000000000000111111111110000000000000000000000011111111111110000000000000000000000000000000000000111111111111111111111
11111110000000000000000111111111110000000000000000000000011111111111110000000000000000000000000000000000000111111111111111111111
11111110000000000000000111111111110000000000000000000000011111111111110000000000000000000000000000000000000111111111111111111111
11111110000000000000000111111111110000000000000000000000011111111111110000000000000000000000000000000000000111111111111111111111
11111110000000000000000111111111110000000000000000000000011111111111110000000000000000000000000000000000000111111111111111111111
11111110000000000000000111111111110000000000000000000000011111111111110000000000000000000000000000000000000111111111111111111111
11111110000000000000000111111111110000000000000000000000011111111111110000000000000000000000000000000000000111111111111111111111
11111110000000000000000111111111110000000000000000000000011111111111110000000000000000000000000000000000000111111111111111111111
11111110000000000000000111111111110000000000000000000000011111111111110000000000000000000000000000000000000111111111111111111111
11111110000000000000000111111111110000000000000000000000011111111111110000000000000000000000000000000000000111111111111111111111
11111111111111111111111111111111111111111111111111111111111111111111110000000000000000000000000000000000000111111111111111111111
11111111111111111111111111111111111111111111111111111111111111111111110000000000000000000000000000000000000111111111111111111111
11111111111111111111111111111111111111111111111111111111111111111111110000000000000000000000000000000000000111111111111111111111
11111111111111111111111111111111111111111111111111111111111111111111110000000000000000000000000000000000000111111111111111111111
11111111111111111111111111111111111111111111111111111111111111111111110000000000000000000000000000000000000111111111111111111111
11111111111111111111111111111111111111111111111111111111111111111111110000000000000000000000000000000000000111111111111111111111
11111111111111111111111111111111111111111111111111111111111111111111111111111111111111111111111111111111111111111111111111111111
11111111111111111111111111111111111111111111111111111111111111111111111111111111111111111111111111111111111111111111111111111111
11111111111111111111111111111111111111111111111111111111111111111111111111111111111111111111111111111111111111111111111111111111
11111111111111111111111111111111111111111111111111111111111111111111111111111111111111111111111111111111111111111111111111111111
11111111111111111111111111111111111111111111111111111111111111111111111111111111111111111111111111111111111111111111111111111111
11111111111111111111111111111111111111111111111111111111111111111111111111111111111111111111111111111111111111111111111111111111
11111111111111111111111111111111111111111111111111111111111111111111111111111111111111111111111111111111111111111111111111111111
