11111111111111111111111111111111111111111111111111111111111111111111111111111111111111111111111111111111111111111111111111111111
11111111111111111111111111111111111111111111111111111111111111111111111111111111111111111111111111111111111111111111111111111111
11111111111111111111111111111111111111111111111111111111111111111111111111111111111111111111111111111111111111111111111111111111
11111111111111111111111111111111111111111111111111111111111111111111111111111111111111111111111111111111111111111111111111111111
11111111111111111111111111111111111111111111111111111111111111111111111111111111111111111111111111111111111111111111111111111111
11111111111111111111111111111111111111111111111111111111111111111111111111111111111111111111111111111111111111111111111111111111
11111111111111111111111111111111111111111111111111111111111111111111111111111111111111111111111111111111111111111111111111111111
11111111111111111111111111111111111111111111111111111111111111111111111111111111111111111111111111111111111111111111111111111111
11111111111111111111111111111111111111111111111111111111111111111111111111111111111111111111111111111111111111111111111111111111
11111111111111111111111111111111111111111111111111111111111111111111111111111111111111111111111111111111111111111111111111111111
11111111111111111111111111111111111111111111111111111111111111111111111111111111111111111111111111111111111111111111111111111111
11111112222222222222222222222222222222222222222222222222222222222222222222222222222222200000000000000000000000000000000011111111
11111112222222000000000000000000011111111111111111111111111111111111111111111111111111000000000000000000000000000000000011111111
11111112222222000000000000000000011111111111111111111111111111111111111111111111111111000000000000000000000000000000000011111111
11111112222222000000000000000000011111111111111111111111111111111111111111111111111111000000000000000000000000000000000011111111
11111112222222000000000000000000011111111111111111111111111111111111111111111111111111000000000000000000000000000000000011111111
11111112222222000000000000000000011111111111111111111111111111111111111111111111111111000000000000000000000000000000000011111111
11111112222222000000000000000000011111111111111111111111111111111111111111111111111111000000000000000000000000000000000011111111
11111112222222000000000000000000011111111111111111111111111111111111111111111111111111000000000000000000000000000000000011111111
11111112222222000000000000000000011111111111111111111111111111111111111111111111111111000000000000000000000000000000000011111111
11111112222222000000000000000000011111111111111111111111111111111111111111111111111111000000000000000000000000000000000011111111
11111112222222111111111111111111111111111111111111111111111111111111111111111111111111111111111111111111111111111111111111111111
11111112222222111111111111111111111111111111111111111111111111111111111111111111111111111111111111111111111111111111111111111111
11111112222222111111111111111111111111111111111111111111111111111111111111111111111111111111111111111111111111111111111111111111
11111112222222111111111111111111111111111111111111111111111111111111111111111111111111111111111111111111111111111111111111111111
11111112222222111111111111111111111111111111111111111111111111111111111111111111111111111111111111111111111111111111111111111111
11111112222222111111111111111111111111111111111111111111111111111111111111111111111111111111111111111111111111111111111111111111
11111112222222111111111111111111111111111111111111111111111111111111111111111111111111111111111111111111111111111111111111111111
11111112222222111111111111111111111111111111111111111111111111111111111111111111111111111111111111111111111111111111111111111111
11111112222222111111111111111111111111111111111111111111111111111111111111111111111111111111111111111111111111111111111111111111
11111112222222111111111111111111111111111111111111111111111111111111111111111111111111111111111111111111111111111111111111111111
11111112222222111111111111111111111111111111111111111111111111111111111111111111111111111111111111111111111111111111111111111111
11111112222222111111111111111111111111111111111111111111111111111111111111111111111111111111111111111111111111111111111111111111
11111112222222111111111111111111111111111111111111111111111111111111111111111111111111111111111111111111111111111111111111111111
11111112222222200000000000000000000000000000000000000000000000000000000000000000000000111111111111111111111111111111111111111111
11111112222222200000000000000000000000000000000000000000000000000000000000000000000000111111111111111111111111111111111111111111
11111112222222200000000000000000000000000000000000000000000000000000000000000000000000111111111111111111111111111111111111111111
11111112222222200000000000000000000000000000000000000000000000000000000000000000000000111111111111111111111111111111111111111111
11111112222222200000000000000000000000000000000000000000000000000000000000000000000000111111111111111111111111111111111111111111
11111112222222200000000000000000000000000000000000000000000000000000000000000000000000111111111111111111111111111111111111111111
11111112222222211111111111111111111111111111111111111111111111111111111111111111111111111111111111111111111111111111111111111111
11111112222222211111111111111111111111111111111111111111111111111111111111111111111111111111111111111111111111111111111111111111
11111112222222211111111111111111111111111111111111111111111111111111111111111111111111111111111111111111111111111111111111111111
11111112222222211111111111111111111111111111111111111111111111111111111111111111111111111111111111111111111111111111111111111111
11111112222222211111111111111111111111111111111111111111111111111111111111111111111111111111111111111111111111111111111111111111
11111112222222211111111111111111111111111111111111111111111111111111111111111111111111111111111111111111111111111111111111111111
11111112222222211111111111111111111111111111111111111111111111111111111111111111111111111111111111111111111111111111111111111111
11111112222222211111111111111111111111111111111111111111111111111111111111111111111111111111111111111111111111111111111111111111
11111112222222211111111111111111111111111111111111111111111111111111111111111111111111111111111111111111111111111111111111111111
11111112222222211111111111111111111111111111111111111111111111111111111111111111111111111111111111111111111111111111111111111111
11111112222222211111111111111111111111111111111111111111111111111111111111111111111111111111111111111111111111111111111111111111
11111112222222211111111111111111111111111111111111111111111111111111111111111111111111111111111111111111111111111111111111111111
11111112222222211111111111111111111111111111111111111111111111111111111111111111111111111111111111111111111111111111111111111111
11111112222222211111111111111111111111111111111111111111111111111111111111111111111111111111111111111111111111111111111111111111
11111112222222211111111111111111111111111111111111111111111111111111111111111111111111111111111111111111111111111111111111111111
11111112222222200000000000000000000000000000000000000000000000000000000000000000000000111111111111111111111111111111111111111111
11111112220000000000000000000000000000000000000000000000000000000000000000000000000000111111111111111111111111111111111111111111
11111112220000000000000000000000000000000000000000000000000000000000000000000000000000111111111111111111111111111111111111111111
11111112220000000000000000000000000000000000000000000000000000000000000000000000000000111111111111111111111111111111111111111111
11111112220000000000000000000000000000000000000000000000000000000000000000000000000000111111111111111111111111111111111111111111
11111112220000000000000000000000000000000000000000000000000000000000000000000000000000111111111111111111111111111111111111111111
11111112221111111111111111111111111111111111111111111111111111111111111111111111111111111111111111111111111111111111111111111111
11111112221111111111111111111111111111111111111111111111111111111111111111111111111111111111111111111111111111111111111111111111
11111112221111111111111111111111111111111111111111111111111111111111111111111111111111111111111111111111111111111111111111111111
11111112221111111111111111111111111111111111111111111111111111111111111111111111111111111111111111111111111111111111111111111111
11111112221111111111111111111111111111111111111111111111111111111111111111111111111111111111111111111111111111111111111111111111
11111112221111111111111111111111111111111111111111111111111111111111111111111111111111111111111111111111111111111111111111111111
11111112221111111111111111111111111111111111111111111111111111111111111111111111111111111111111111111111111111111111111111111111
11111112221111111111111111111111111111111111111111111111111111111111111111111111111111111111111111111111111111111111111111111111
11111112221111111111111111111111111111111111111111111111111111111111111111111111111111111111111111111111111111111111111111111111
11111112221111111111111111111111111111111111111111111111111111111111111111111111111111111111111111111111111111111111111111111111
11111112221111111111111111111111111111111111111111111111111111111111111111111111111111111111111111111111111111111111111111111111
11111112221111111111111111111111111111111111111111111111111111111111111111111111111111111111111111111111111111111111111111111111
11111112221111111111111111111111111111111111111111111111111111111111111111111111111111111111111111111111111111111111111111111111
11111112222222222222222222222222222222222222222222222222222222222222222111111111111111111111111111111111111111111111111111111111
11111112222222222222222222222222222222222222222222222222222222222222222200000000000000000000000000000000001111111111111111111111
11111112222222222222222222222222222000000000000000000000011111111111112200000000000000000000000000000000001111111111111111111111
11111112222222222222222222222222222000000000000000000000011111111111112200000000000000000000000000000000001111111111111111111111
11111112222222222222222222222222222000000000000000000000011111111111112200000000000000000000000000000000001111111111111111111111
11111112222222222222222222222222222000000000000000000000011111111111112200000000000000000000000000000000001111111111111111111111
11111112222222222222222222222222222000000000000000000000011111111111112200000000000000000000000000000000001111111111111111111111
11111112222222222222222222222222222000000000000000000000011111111111112200000000000000000000000000000000001111111111111111111111
11111112222222222222222222222222222000000000000000000000011111111111112200000000000000000000000000000000001111111111111111111111
11111112222222222222222222222222222000000000000000000000011111111111112200000000000000000000000000000000001111111111111111111111
11111112222222222222222222222222222000000000000000000000011111111111112200000000000000000000000000000000001111111111111111111111
11111112222222222222222222222222222000000000000000000000011111111111112211111111111111111111111111111111111111111111111111111111
11111112222222222222222222222222222000000000000000000000011111111111112211111111111111111111111111111111111111111111111111111111
11111112222222222222222222222222222000000000000000000000011111111111112211111111111111111111111111111111111111111111111111111111
11111112222222222222222222222222222000000000000000000000011111111111112211111111111111111111111111111111111111111111111111111111
11111112222222222222222222222222222000000000000000000000011111111111112211111111111111111111111111111111111111111111111111111111
11111112222222222222222222222222222000000000000000000000011111111111112211111111111111111111111111111111111111111111111111111111
11111110000000000000000111111111110000000000000000000000011111111111112211111111111111111111111111111111111111111111111111111111
11111110000000000000000111111111110000000000000000000000011111111111112211111111111111111111111111111111111111111111111111111111
11111110000000000000000111111111110000000000000000000000011111111111112211111111111111111111111111111111111111111111111111111111
11111110000000000000000111111111110000000000000000000000011111111111112211111111111111111111111111111111111111111111111111111111
11111110000000000000000111111111110000000000000000000000011111111111112211111111111111111111111111111111111111111111111111111111
11111110000000000000000111111111110000000000000000000000011111111111112211111111111111111111111111111111111111111111111111111111
11111110000000000000000111111111110000000000000000000000011111111111112211111111111111111111111111111111111111111111111111111111
11111110000000000000000111111111110000000000000000000000011111111111112211111111111111111111111111111111111111111111111111111111
11111110000000000000000111111111110000000000000000000000011111111111112211111111111111111111111111111111111111111111111111111111
11111110000000000000000111111111110000000000000000000000011111111111112211111111111111111111111111111111111111111111111111111111
11111110000000000000000111111111110000000000000000000000011111111111112211111111111111111111111111111111111111111111111111111111
11111110000000000000000111111111110000000000000000000000011111111111112211111111111111111111111111111111111111111111111111111111
11111110000000000000000111111111110000000000000000000000011111111111112211111111111111111111111111111111111111111111111111111111
11111110000000000000000111111111110000000000000000000000011111111111112211111111111111111111111111111111111111111111111111111111
11111110000000000000000111111111110000000000000000000000011111111111112200000000000000000000000000000000000111111111111111111111
11111110000000000000000111111111110000000000000000000000011111111111110000000000000000000000000000000000000111111111111111111111
11111110000000000000000111111111110000000000000000000000011111111111110000000000000000000000000000000000000111111111111111111111
11111110000000000000000111111111110000000000000000000000011111111111110000000000000000000000000000000000000111111111111111111111
11111110000000000000000111111111110000000000000000000000011111111111110000000000000000000000000000000000000111111111111111111111
11111110000000000000000111111111110000000000000000000000011111111111110000000000000000000000000000000000000111111111111111111111
11111110000000000000000111111111110000000000000000000000011111111111110000000000000000000000000000000000000111111111111111111111
11111110000000000000000111111111110000000000000000000000011111111111110000000000000000000000000000000000000111111111111111111111
11111110000000000000000111111111110000000000000000000000011111111111110000000000000000000000000000000000000111111111111111111111
11111110000000000000000111111111110000000000000000000000011111111111110000000000000000000000000000000000000111111111111111111111
11111111111111111111111111111111111111111111111111111111111111111111110000000000000000000000000000000000000111111111111111111111
11111111111111111111111111111111111111111111111111111111111111111111110000000000000000000000000000000000000111111111111111111111
11111111111111111111111111111111111111111111111111111111111111111111110000000000000000000000000000000000000111111111111111111111
11111111111111111111111111111111111111111111111111111111111111111111110000000000000000000000000000000000000111111111111111111111
11111111111111111111111111111111111111111111111111111111111111111111110000000000000000000000000000000000000111111111111111111111
11111111111111111111111111111111111111111111111111111111111111111111110000000000000000000000000000000000000111111111111111111111
11111111111111111111111111111111111111111111111111111111111111111111111111111111111111111111111111111111111111111111111111111111
11111111111111111111111111111111111111111111111111111111111111111111111111111111111111111111111111111111111111111111111111111111
11111111111111111111111111111111111111111111111111111111111111111111111111111111111111111111111111111111111111111111111111111111
11111111111111111111111111111111111111111111111111111111111111111111111111111111111111111111111111111111111111111111111111111111
11111111111111111111111111111111111111111111111111111111111111111111111111111111111111111111111111111111111111111111111111111111
11111111111111111111111111111111111111111111111111111111111111111111111111111111111111111111111111111111111111111111111111111111
11111111111111111111111111111111111111111111111111111111111111111111111111111111111111111111111111111111111111111111111111111111
