1111111111111111111111111111111111111111111111111111111111111111
1222222222222222222222222222222222222200000000001111111111111111
1222222222222222222222222222222222222200000000001111111111111111
1222222222222222222222222222222222222200000000001111111111111111
1222222222222222222222222222222222222200000000001111111111111111
1222222222222222222222222222222222222200000000001111111111111111
1222220000001111111111111111111111222200000000001111111111111111
1222220000001111111111111111111111222211111111111111111111111111
1222220000001111111111111111111111222211111111111111111111111111
1222221111111111111111111111111111222211111111111111111111111111
1222221111111111111111111111111111222211111111111111111111111111
1222221111111111111111111111111111222211111111111111111111111111
1222221111111111111111111111111111222211111111111111111111111111
1222221111111111111111111111111111222211111111111111111111111111
1222221111111111111111111111111111222211111111111111111111111111
1222221111111111111111111111111111222211111111111111111111111111
1222221111111111111111111111111111222211111111111111111111111111
1222221111111111111111111111111111222211111111111111111111111111
1222220000111111111111111111111111222211111111111111111111111111
1222220000111111111111111111111111222211111111111111111111111111
1222220000111111111111111111111111222200000000000011111111111111
1222220000111111111111111111111111111000000000000011111111111111
1222220000111111111111111111111111111000000000000011111111111111
1222220000111111111111111111111111111000000000000011111111111111
1222220000111111111111111111111111111000000000000011111111111111
1222220000111111111111111111111111111000000000000011111111111111
1222221111111111111111111111111111111111111111111111111111111111
1222221111111111111111111111111111111111111111111111111111111111
1222221111111111111111111111111111111111111111111111111111111111
1222221111111111111111111111111111111111111111111111111111111111
1222221111111111111111111111111111111111111111111111111111111111
1222222222222222222222000000000000000000000000000001111111111111
1111122222222222222222000000000000000000000000000001111111111111
1111122222222222222222111111111111111111111111111111111111111111
1111122222222222222222111111111111111111111111111111111111111111
1111122222222222222222001111111111111111111111111111111111111111
1111122222200000000000001111111111111111111111111111111111111111
1111122222200000000000001111111111111111111111111111111111111111
1111122222211111111111111111111111111111111111111111111111111111
1111122222211111111111111111111111111111111111111111111111111111
1111122222211111111111111111111111111111111111111111111111111111
1111122222211111111111111111111111111111111111111111111111111111
1111122222211111111111111111111111111111111111111111111111111111
1111122222211111111111111111111111111111111111111111111111111111
1111122222211111111111111111111111111111111111111111111111111111
1111122222211111111111111111111111111111111111111111111111111111
1111122222211111111111111111111111111111111111111111111111111111
1111122222222222000000000000000000000000000000111111111111111111
1111111111222222000000000000000000000000000000111111111111111111
1111111111222222000000000000000000000000000000111111111111111111
1111111111222222111111111111111111111111111111111111111111111111
1111111111222222111111111111111111111111111111111111111111111111
1111111111222222111111111111111111111111111111111111111111111111
1111111111222222111111111111111111111111111111111111111111111111
1111111111222222000000000000000000000000000000111111111111111111
1111111111000000000000000000000000000000000000111111111111111111
1111111111000000000000000000000000000000000000111111111111111111
1111111111000000000000000000000000000000000000111111111111111111
1111111111111111111111111111111111111111111111111111111111111111
1111111111111111111111111111111111111111111111111111111111111111
1111111111111111111111111111111111111111111111111111111111111111
1111111111111111111111111111111111111111111111111111111111111111
1111111111111111111111111111111111111111111111111111111111111111
1111111111111111111111111111111111111111111111111111111111111111
