00102222
00102222
00102222
00110000
00011100
22000100
22200100
22200100