11111111111111111111111111111111111111111111111111111111111111111111111111111111111111111111111111111111111111111111111111111111
11111111111111111111111111111111111111111111111111111111111111111111111111111111111111111111111111111111111111111111111111111111
11111111111111111111111111111111111111111111111111111111111111111111111111111111111111111111111111111111111111111111111111111111
11111111111111111111111111111111111111111111111111111111111111111111111111111111111111111111111111111111111111111111111111111111
11111111111111111111111111111111111111111111111111111111111111111111111111111111111111111111111111111111111111111111111111111111
11111111111111111111111111111111111111111111111111111111111111111111111111111111111111111111111111111111111111111111111111111111
11111111111111111111111111111111111111111111111111111111111111111111111111111111111111111111111111111111111111111111111111111111
11111111111111111111111111111111111111111111111111111111111111111111111111111111111111111111111111111111111111111111111111111111
11111111111111111111111111111111111111111111111111111111111111111111111111111111111111111111111111111111111111111111111111111111
11111111111111111111111111111111111111111111111111111111111111111111111111111111111111111111111111111111111111111111111111111111
11111111111111222222222222222222222222222222222222222222222222222222222222222222220000000000000000000000000000000000000011111111
11111111111111222222222222222222222222222222222222222222222222222222222222222222220000000000000000000000000000000000000011111111
11111111111111222222222222222222222222222222222222222222222222222222222222222222220000000000000000000000000000000000000011111111
11111111111111222222222222222200000000000000000000000000000001111111111111111111100000000000000000000000000000000000000011111111
11111111111111222222222222222200000000000000000000000000000001111111111111111111100000000000000000000000000000000000000011111111
11111111111111222222222222222200000000000000000000000000000001111111111111111111100000000000000000000000000000000000000011111111
11111111111111222222222222222200000000000000000000000000000001111111111111111111100000000000000000000000000000000000000011111111
11111111111111222222222222222200000000000000000000000000000001111111111111111111100000000000000000000000000000000000000011111111
11111111111111222222222222222200000000000000000000000000000001111111111111111111100000000000000000000000000000000000000011111111
11111111111111222222222222222200000000000000000000000000000001111111111111111111100000000000000000000000000000000000000011111111
11111111111111222222222222222211111111111111111111111111111111111111111111111111100000000000000000000000000000000000000011111111
11111111111111222222222222222211111111111111111111111111111111111111111111111111100000000000000000000000000000000000000011111111
11111111111111222222222222222211111111111111111111111111111111111111111111111111100000000000000000000000000000000000000011111111
11111111111111222222222222222211111111111111111111111111111111111111111111111111100000000000000000000000000000000000000011111111
11111111111111222222222222222211111111111111111111111111111111111111111111111111111111111111111111111111111111111111111111111111
11111111111111222222222222222211111111111111111111111111111111111111111111111111111111111111111111111111111111111111111111111111
11111111111111222222222222222211111111111111111111111111111111111111111111111111111111111111111111111111111111111111111111111111
11111111111111222222222222222211111111111111111111111111111111111111111111111111111111111111111111111111111111111111111111111111
11111111111111222222222222222222222222222222222222222222222222222222222211111111111111111111111111111111111111111111111111111111
11111111111111222222222222222222222222222222222222222222222222222222222200000000000000000000000000000011111111111111111111111111
11111111111111222222222222222200000000011111111111111111111111111111111000000000000000000000000000000011111111111111111111111111
11111111111111222222222222222200000000011111111111111111111111111111111000000000000000000000000000000011111111111111111111111111
11111111111111222222222222222200000000011111111111111111111111111111111000000000000000000000000000000011111111111111111111111111
11111111111111222222222222222200000000011111111111111111111111111111111000000000000000000000000000000011111111111111111111111111
11111111111111222222222222222200000000011111111111111111111111111111111000000000000000000000000000000011111111111111111111111111
11111111111111222222222222222200000000011111111111111111111111111111111000000000000000000000000000000011111111111111111111111111
11111111111111222222222222222200000000011111111111111111111111111111111000000000000000000000000000000011111111111111111111111111
11111111111111222222222222222200000000011111111111111111111111111111111000000000000000000000000000000011111111111111111111111111
11111111111111222222222222222200000000011111111111111111111111111111111000000000000000000000000000000011111111111111111111111111
11111111111111222222222222222200000000011111111111111111111111111111111000000000000000000000000000000011111111111111111111111111
11111111111111222222222222222200000000011111111111111111111111111111111000000000000000000000000000000011111111111111111111111111
11111111111111222222222222222200000000011111111111111111111111111111111111111111111111111111111111111111111111111111111111111111
11111111111111222222222222222200000000011111111111111111111111111111111111111111111111111111111111111111111111111111111111111111
11111111111111222222222222222200000000011111111111111111111111111111111111111111111111111111111111111111111111111111111111111111
11111111111111222222222222222200000000011111111111111111111111111111111111111111111111111111111111111111111111111111111111111111
11111111111111222222222222222200000000011111111111111111111111111111111111111111111111111111111111111111111111111111111111111111
11111111111111222222222222222200000000011111111111111111111111111111111111111111111111111111111111111111111111111111111111111111
11111111111111222222222222222200000000011111111111111111111111111111111111111111111111111111111111111111111111111111111111111111
11111111111111222222222222222200000000011111111111111111111111111111111111111111111111111111111111111111111111111111111111111111
11111111111111222222222222222200000000011111111111111111111111111111111111111111111111111111111111111111111111111111111111111111
11111111111111222222222222222200000000011111111111111111111111111111111111111111111111111111111111111111111111111111111111111111
11111111111111222222222222222200000000011111111111111111111111111111111111111111111111111111111111111111111111111111111111111111
11111111111111222222222222222200000000011111111111111111111111111111111111111111111111111111111111111111111111111111111111111111
11111111111111222222222222222200000000011111111111111111111111111111111111111111111111111111111111111111111111111111111111111111
11111111111111222222222222222200000000011111111111111111111111111111111111111111111111111111111111111111111111111111111111111111
11111111111111222222222222222211111111111111111111111111111111111111111111111111111111111111111111111111111111111111111111111111
11111111111111222222222222222211111111111111111111111111111111111111111111111111111111111111111111111111111111111111111111111111
11111111111111222222222222222211111111111111111111111111111111111111111111111111111111111111111111111111111111111111111111111111
11111111111111222222222222222211111111111111111111111111111111111111111111111111111111111111111111111111111111111111111111111111
11111111111111222222222222222211111111111111111111111111111111111111111111111111111111111111111111111111111111111111111111111111
11111111111111222222222222222211111111111111111111111111111111111111111111111111111111111111111111111111111111111111111111111111
11111111111111222222222222222211111111111111111111111111111111111111111111111111111111111111111111111111111111111111111111111111
11111111111111222222222222222211111111111111111111111111111111111111111111111111111111111111111111111111111111111111111111111111
11111111111111222222222222222211111111111111111111111111111111111111111111111111111111111111111111111111111111111111111111111111
11111111111111222222222222222211111111111111111111111111111111111111111111111111111111111111111111111111111111111111111111111111
11111111111111222222222222222211111111111111111111111111111111111111111111111111111111111111111111111111111111111111111111111111
11111111111111222222222222222211111111111111111111111111111111111111111111111111111111111111111111111111111111111111111111111111
11111111111111222222222222222222222222222222222222222222222222222222222222222221111111111111111111111111111111111111111111111111
11111111111111111111111111111222222222222222222222222222222222222222222222222221111111111111111111111111111111111111111111111111
11111111111111111111111111111222222222222222222222222222222222222222222222222221111111111111111111111111111111111111111111111111
11111111111111111111111111111222222222222222222222222222222222222222222222222221111111111111111111111111111111111111111111111111
11111111111111111111111111111222222222222222222222222222222222222222222222222221111111111111111111111111111111111111111111111111
11111111111111111111111111111222222222222222222222222222222222222222222222222221111111111111111111111111111111111111111111111111
11111111111111111111111111111222222222222222222222222222222222222222222222222221111111111111111111111111111111111111111111111111
11111111111111111111111111111222222222222222222222222222222222222222222222222222222222200000000000000000000000000000001111111111
11111111111111111111111111111220000000000000000000011111111111111111111111111122222222200000000000000000000000000000001111111111
11111111111111111111111111111220000000000000000000011111111111111111111111111122222222200000000000000000000000000000001111111111
11111111111111111111111111111220000000000000000000011111111111111111111111111122222222200000000000000000000000000000001111111111
11111111111111111111111111111220000000000000000000011111111111111111111111111122222222200000000000000000000000000000001111111111
11111111111111111111111111111220000000000000000000011111111111111111111111111122222222200000000000000000000000000000001111111111
11111111111111111111111111111220000000000000000000011111111111111111111111111122222222200000000000000000000000000000001111111111
11111111111111111111111111111220000000000000000000011111111111111111111111111122222222200000000000000000000000000000001111111111
11111111111111111111111111111220000000000000000000011111111111111111111111111122222222200000000000000000000000000000001111111111
11111111111111111111111111111221111111111111111111111111111111111111111111111122222222200000000000000000000000000000001111111111
11111111111111111111111111111221111111111111111111111111111111111111111111111122222222200000000000000000000000000000001111111111
11111111111111111111111111111221111111111111111111111111111111111111111111111122222222200000000000000000000000000000001111111111
11111111111111111111111111111221111111111111111111111111111111111111111111111122222222200000000000000000000000000000001111111111
11111111111111111111111111111221111111111111111111111111111111111111111111111122222222200000000000000000000000000000001111111111
11111111111111111111111111111221111111111111111111111111111111111111111111111122222222200000000000000000000000000000001111111111
11111111111111111111111111111221111111111111111111111111111111111111111111111122222222211111111111111111111111111111111111111111
11111111111111111111111111111221111111111111111111111111111111111111111111111122222222211111111111111111111111111111111111111111
11111111111111111111111111111221111111111111111111111111111111111111111111111122222222211111111111111111111111111111111111111111
11111111111111111111111111111221111111111111111111111111111111111111111111111122222222211111111111111111111111111111111111111111
11111111111111111111111111111221111111111111111111111111111111111111111111111122222222211111111111111111111111111111111111111111
11111111111111111111111111111221111111111111111111111111111111111111111111111122222222211111111111111111111111111111111111111111
11111111111111111111111111111221111111111111111111111111111111111111111111111122222222211111111111111111111111111111111111111111
11111111111111111111111111111221111111111111111111111111111111111111111111111122222222211111111111111111111111111111111111111111
11111111111111111111111111111221111111111111111111111111111111111111111111111122222222211111111111111111111111111111111111111111
11111111111111111111111111111221111111111111111111111111111111111111111111111122222222211111111111111111111111111111111111111111
11111111111111111111111111111221111111111111111111111111111111111111111111111122222222200000000000000000000000001111111111111111
11111111111111111111111111111221111111111111111111111111111111111111111111111111111111000000000000000000000000001111111111111111
11111111111111111111111111111221111111111111111111111111111111111111111111111111111111000000000000000000000000001111111111111111
11111111111111111111111111111220000000000000000000000000000000111111111111111111111111000000000000000000000000001111111111111111
11111111111111111111111111111000000000000000000000000000000000111111111111111111111111000000000000000000000000001111111111111111
11111111111111111111111111111000000000000000000000000000000000111111111111111111111111000000000000000000000000001111111111111111
11111111111111111111111111111000000000000000000000000000000000111111111111111111111111000000000000000000000000001111111111111111
11111111111111111111111111111000000000000000000000000000000000111111111111111111111111000000000000000000000000001111111111111111
11111111111111111111111111111000000000000000000000000000000000111111111111111111111111000000000000000000000000001111111111111111
11111111111111111111111111111000000000000000000000000000000000111111111111111111111111000000000000000000000000001111111111111111
11111111111111111111111111111000000000000000000000000000000000111111111111111111111111000000000000000000000000001111111111111111
11111111111111111111111111111000000000000000000000000000000000111111111111111111111111000000000000000000000000001111111111111111
11111111111111111111111111111000000000000000000000000000000000111111111111111111111111000000000000000000000000001111111111111111
11111111111111111111111111111000000000000000000000000000000000111111111111111111111111111111111111111111111111111111111111111111
11111111111111111111111111111000000000000000000000000000000000111111111111111111111111111111111111111111111111111111111111111111
11111111111111111111111111111000000000000000000000000000000000111111111111111111111111111111111111111111111111111111111111111111
11111111111111111111111111111000000000000000000000000000000000111111111111111111111111111111111111111111111111111111111111111111
11111111111111111111111111111000000000000000000000000000000000111111111111111111111111111111111111111111111111111111111111111111
11111111111111111111111111111000000000000000000000000000000000111111111111111111111111111111111111111111111111111111111111111111
11111111111111111111111111111000000000000000000000000000000000111111111111111111111111111111111111111111111111111111111111111111
11111111111111111111111111111000000000000000000000000000000000111111111111111111111111111111111111111111111111111111111111111111
11111111111111111111111111111000000000000000000000000000000000111111111111111111111111111111111111111111111111111111111111111111
11111111111111111111111111111000000000000000000000000000000000111111111111111111111111111111111111111111111111111111111111111111
11111111111111111111111111111000000000000000000000000000000000111111111111111111111111111111111111111111111111111111111111111111
11111111111111111111111111111111111111111111111111111111111111111111111111111111111111111111111111111111111111111111111111111111
11111111111111111111111111111111111111111111111111111111111111111111111111111111111111111111111111111111111111111111111111111111
11111111111111111111111111111111111111111111111111111111111111111111111111111111111111111111111111111111111111111111111111111111
11111111111111111111111111111111111111111111111111111111111111111111111111111111111111111111111111111111111111111111111111111111
11111111111111111111111111111111111111111111111111111111111111111111111111111111111111111111111111111111111111111111111111111111
