11111111111111111111111111111111111111111111111111111111111111111111111111111111111111111111111111111111111111111111111111111111
11111111111111111111111111111111111111111111111111111111111111111111111111111111111111111111111111111111111111111111111111111111
11111111111111111111111111111111111111111111111111111111111111111111111111111111111111111111111111111111111111111111111111111111
11111111111111111111111111111111111111111111111111111111111111111111111111111111111111111111111111111111111111111111111111111111
11111111111111111111111111111111111111111111111111111111111111111111111111111111111111111111111111111111111111111111111111111111
11111111111111111111111111111111111111111111111111111111111111111111111111111111111111111111111111111111111111111111111111111111
11111111111111111111111111111111111111111111111111111111111111111111111111111111111111111111111111111111111111111111111111111111
11111111111111111111111111111111111111111111111111111111111111111111111111111111111111111111111111111111111111111111111111111111
11111111111111111111111111111111111111111111111111111111111111111111111111111111111111111111111111111111111111111111111111111111
11111111111111111111111111111111111111111111111111111111111111111111111111111111111111111111111111111111111111111111111111111111
11111111111111222222222222222222222222222222222222222222222222222222222222222222200000000000000000000000000000000000000011111111
11111111111111222222222222222222222222222222222222222222222222222222222222222222200000000000000000000000000000000000000011111111
11111111111111222222222222222000000000000000000000000000000001111111111111111111100000000000000000000000000000000000000011111111
11111111111111222222222222222000000000000000000000000000000001111111111111111111100000000000000000000000000000000000000011111111
11111111111111222222222222222000000000000000000000000000000001111111111111111111100000000000000000000000000000000000000011111111
11111111111111222222222222222000000000000000000000000000000001111111111111111111100000000000000000000000000000000000000011111111
11111111111111222222222222222000000000000000000000000000000001111111111111111111100000000000000000000000000000000000000011111111
11111111111111222222222222222000000000000000000000000000000001111111111111111111100000000000000000000000000000000000000011111111
11111111111111222222222222222000000000000000000000000000000001111111111111111111100000000000000000000000000000000000000011111111
11111111111111222222222222222000000000000000000000000000000001111111111111111111100000000000000000000000000000000000000011111111
11111111111111222222222222222111111111111111111111111111111111111111111111111111100000000000000000000000000000000000000011111111
11111111111111222222222222222111111111111111111111111111111111111111111111111111100000000000000000000000000000000000000011111111
11111111111111222222222222222111111111111111111111111111111111111111111111111111100000000000000000000000000000000000000011111111
11111111111111222222222222222111111111111111111111111111111111111111111111111111100000000000000000000000000000000000000011111111
11111111111111222222222222222111111111111111111111111111111111111111111111111111111111111111111111111111111111111111111111111111
11111111111111222222222222222111111111111111111111111111111111111111111111111111111111111111111111111111111111111111111111111111
11111111111111222222222222222111111111111111111111111111111111111111111111111111111111111111111111111111111111111111111111111111
11111111111111222222222222222111111111111111111111111111111111111111111111111111111111111111111111111111111111111111111111111111
11111111111111222222222222222222222222222222222222222222222222222222222111111111111111111111111111111111111111111111111111111111
11111111111111222222222222222000000000011111111111111111111111111111111000000000000000000000000000000011111111111111111111111111
11111111111111222222222222222000000000011111111111111111111111111111111000000000000000000000000000000011111111111111111111111111
11111111111111222222222222222000000000011111111111111111111111111111111000000000000000000000000000000011111111111111111111111111
11111111111111222222222222222000000000011111111111111111111111111111111000000000000000000000000000000011111111111111111111111111
11111111111111222222222222222000000000011111111111111111111111111111111000000000000000000000000000000011111111111111111111111111
11111111111111222222222222222000000000011111111111111111111111111111111000000000000000000000000000000011111111111111111111111111
11111111111111222222222222222000000000011111111111111111111111111111111000000000000000000000000000000011111111111111111111111111
11111111111111222222222222222000000000011111111111111111111111111111111000000000000000000000000000000011111111111111111111111111
11111111111111222222222222222000000000011111111111111111111111111111111000000000000000000000000000000011111111111111111111111111
11111111111111222222222222222000000000011111111111111111111111111111111000000000000000000000000000000011111111111111111111111111
11111111111111222222222222222000000000011111111111111111111111111111111000000000000000000000000000000011111111111111111111111111
11111111111111222222222222222000000000011111111111111111111111111111111000000000000000000000000000000011111111111111111111111111
11111111111111222222222222222000000000011111111111111111111111111111111111111111111111111111111111111111111111111111111111111111
11111111111111222222222222222000000000011111111111111111111111111111111111111111111111111111111111111111111111111111111111111111
11111111111111222222222222222000000000011111111111111111111111111111111111111111111111111111111111111111111111111111111111111111
11111111111111222222222222222000000000011111111111111111111111111111111111111111111111111111111111111111111111111111111111111111
11111111111111222222222222222000000000011111111111111111111111111111111111111111111111111111111111111111111111111111111111111111
11111111111111222222222222222000000000011111111111111111111111111111111111111111111111111111111111111111111111111111111111111111
11111111111111222222222222222000000000011111111111111111111111111111111111111111111111111111111111111111111111111111111111111111
11111111111111222222222222222000000000011111111111111111111111111111111111111111111111111111111111111111111111111111111111111111
11111111111111222222222222222000000000011111111111111111111111111111111111111111111111111111111111111111111111111111111111111111
11111111111111222222222222222000000000011111111111111111111111111111111111111111111111111111111111111111111111111111111111111111
11111111111111222222222222222000000000011111111111111111111111111111111111111111111111111111111111111111111111111111111111111111
11111111111111222222222222222000000000011111111111111111111111111111111111111111111111111111111111111111111111111111111111111111
11111111111111222222222222222000000000011111111111111111111111111111111111111111111111111111111111111111111111111111111111111111
11111111111111222222222222222000000000011111111111111111111111111111111111111111111111111111111111111111111111111111111111111111
11111111111111222222222222222111111111111111111111111111111111111111111111111111111111111111111111111111111111111111111111111111
11111111111111222222222222222111111111111111111111111111111111111111111111111111111111111111111111111111111111111111111111111111
11111111111111222222222222222111111111111111111111111111111111111111111111111111111111111111111111111111111111111111111111111111
11111111111111222222222222222111111111111111111111111111111111111111111111111111111111111111111111111111111111111111111111111111
11111111111111222222222222222111111111111111111111111111111111111111111111111111111111111111111111111111111111111111111111111111
11111111111111222222222222222111111111111111111111111111111111111111111111111111111111111111111111111111111111111111111111111111
11111111111111222222222222222111111111111111111111111111111111111111111111111111111111111111111111111111111111111111111111111111
11111111111111222222222222222111111111111111111111111111111111111111111111111111111111111111111111111111111111111111111111111111
11111111111111222222222222222111111111111111111111111111111111111111111111111111111111111111111111111111111111111111111111111111
11111111111111222222222222222111111111111111111111111111111111111111111111111111111111111111111111111111111111111111111111111111
11111111111111222222222222222111111111111111111111111111111111111111111111111111111111111111111111111111111111111111111111111111
11111111111111222222222222222111111111111111111111111111111111111111111111111111111111111111111111111111111111111111111111111111
11111111111111111111111111111222222222222222222222222222222222222222222222222211111111111111111111111111111111111111111111111111
11111111111111111111111111111222222222222222222222222222222222222222222222222211111111111111111111111111111111111111111111111111
11111111111111111111111111111222222222222222222222222222222222222222222222222211111111111111111111111111111111111111111111111111
11111111111111111111111111111222222222222222222222222222222222222222222222222211111111111111111111111111111111111111111111111111
11111111111111111111111111111222222222222222222222222222222222222222222222222211111111111111111111111111111111111111111111111111
11111111111111111111111111111222222222222222222222222222222222222222222222222211111111111111111111111111111111111111111111111111
11111111111111111111111111111222222222222222222222222222222222222222222222222211111111111111111111111111111111111111111111111111
11111111111111111111111111111200000000000000000000011111111111111111111111111122222222000000000000000000000000000000001111111111
11111111111111111111111111111200000000000000000000011111111111111111111111111122222222000000000000000000000000000000001111111111
11111111111111111111111111111200000000000000000000011111111111111111111111111122222222000000000000000000000000000000001111111111
11111111111111111111111111111200000000000000000000011111111111111111111111111122222222000000000000000000000000000000001111111111
11111111111111111111111111111200000000000000000000011111111111111111111111111122222222000000000000000000000000000000001111111111
11111111111111111111111111111200000000000000000000011111111111111111111111111122222222000000000000000000000000000000001111111111
11111111111111111111111111111200000000000000000000011111111111111111111111111122222222000000000000000000000000000000001111111111
11111111111111111111111111111200000000000000000000011111111111111111111111111122222222000000000000000000000000000000001111111111
11111111111111111111111111111200000000000000000000011111111111111111111111111122222222000000000000000000000000000000001111111111
11111111111111111111111111111211111111111111111111111111111111111111111111111122222222000000000000000000000000000000001111111111
11111111111111111111111111111211111111111111111111111111111111111111111111111122222222000000000000000000000000000000001111111111
11111111111111111111111111111211111111111111111111111111111111111111111111111122222222000000000000000000000000000000001111111111
11111111111111111111111111111211111111111111111111111111111111111111111111111122222222000000000000000000000000000000001111111111
11111111111111111111111111111211111111111111111111111111111111111111111111111122222222000000000000000000000000000000001111111111
11111111111111111111111111111211111111111111111111111111111111111111111111111122222222000000000000000000000000000000001111111111
11111111111111111111111111111211111111111111111111111111111111111111111111111122222222111111111111111111111111111111111111111111
11111111111111111111111111111211111111111111111111111111111111111111111111111122222222111111111111111111111111111111111111111111
11111111111111111111111111111211111111111111111111111111111111111111111111111122222222111111111111111111111111111111111111111111
11111111111111111111111111111211111111111111111111111111111111111111111111111122222222111111111111111111111111111111111111111111
11111111111111111111111111111211111111111111111111111111111111111111111111111122222222111111111111111111111111111111111111111111
11111111111111111111111111111211111111111111111111111111111111111111111111111122222222111111111111111111111111111111111111111111
11111111111111111111111111111211111111111111111111111111111111111111111111111122222222111111111111111111111111111111111111111111
11111111111111111111111111111211111111111111111111111111111111111111111111111122222222111111111111111111111111111111111111111111
11111111111111111111111111111211111111111111111111111111111111111111111111111122222222111111111111111111111111111111111111111111
11111111111111111111111111111211111111111111111111111111111111111111111111111122222222111111111111111111111111111111111111111111
11111111111111111111111111111211111111111111111111111111111111111111111111111111111111000000000000000000000000001111111111111111
11111111111111111111111111111211111111111111111111111111111111111111111111111111111111000000000000000000000000001111111111111111
11111111111111111111111111111211111111111111111111111111111111111111111111111111111111000000000000000000000000001111111111111111
11111111111111111111111111111000000000000000000000000000000000111111111111111111111111000000000000000000000000001111111111111111
11111111111111111111111111111000000000000000000000000000000000111111111111111111111111000000000000000000000000001111111111111111
11111111111111111111111111111000000000000000000000000000000000111111111111111111111111000000000000000000000000001111111111111111
11111111111111111111111111111000000000000000000000000000000000111111111111111111111111000000000000000000000000001111111111111111
11111111111111111111111111111000000000000000000000000000000000111111111111111111111111000000000000000000000000001111111111111111
11111111111111111111111111111000000000000000000000000000000000111111111111111111111111000000000000000000000000001111111111111111
11111111111111111111111111111000000000000000000000000000000000111111111111111111111111000000000000000000000000001111111111111111
11111111111111111111111111111000000000000000000000000000000000111111111111111111111111000000000000000000000000001111111111111111
11111111111111111111111111111000000000000000000000000000000000111111111111111111111111000000000000000000000000001111111111111111
11111111111111111111111111111000000000000000000000000000000000111111111111111111111111000000000000000000000000001111111111111111
11111111111111111111111111111000000000000000000000000000000000111111111111111111111111111111111111111111111111111111111111111111
11111111111111111111111111111000000000000000000000000000000000111111111111111111111111111111111111111111111111111111111111111111
11111111111111111111111111111000000000000000000000000000000000111111111111111111111111111111111111111111111111111111111111111111
11111111111111111111111111111000000000000000000000000000000000111111111111111111111111111111111111111111111111111111111111111111
11111111111111111111111111111000000000000000000000000000000000111111111111111111111111111111111111111111111111111111111111111111
11111111111111111111111111111000000000000000000000000000000000111111111111111111111111111111111111111111111111111111111111111111
11111111111111111111111111111000000000000000000000000000000000111111111111111111111111111111111111111111111111111111111111111111
11111111111111111111111111111000000000000000000000000000000000111111111111111111111111111111111111111111111111111111111111111111
11111111111111111111111111111000000000000000000000000000000000111111111111111111111111111111111111111111111111111111111111111111
11111111111111111111111111111000000000000000000000000000000000111111111111111111111111111111111111111111111111111111111111111111
11111111111111111111111111111000000000000000000000000000000000111111111111111111111111111111111111111111111111111111111111111111
11111111111111111111111111111111111111111111111111111111111111111111111111111111111111111111111111111111111111111111111111111111
11111111111111111111111111111111111111111111111111111111111111111111111111111111111111111111111111111111111111111111111111111111
11111111111111111111111111111111111111111111111111111111111111111111111111111111111111111111111111111111111111111111111111111111
11111111111111111111111111111111111111111111111111111111111111111111111111111111111111111111111111111111111111111111111111111111
11111111111111111111111111111111111111111111111111111111111111111111111111111111111111111111111111111111111111111111111111111111
