11111111111111111111111111111111111111111111111111111111111111111111111111111111111111111111111111111111111111111111111111111111
11111111111111111111111111111111111111111111111111111111111111111111111111111111111111111111111111111111111111111111111111111111
11111111111111111111111111111111111111111111111111111111111111111111111111111111111111111111111111111111111111111111111111111111
11111111111111111111111111111111111111111111111111111111111111111111111111111111111111111111111111111111111111111111111111111111
11111111111111111111111111111111111111111111111111111111111111111111111111111111111111111111111111111111111111111111111111111111
11111111111111111111111111111111111111111111111111111111111111111111111111111111111111111111111111111111111111111111111111111111
11111111111111111111111111111111111111111111111111111111111111111111111111111111111111111111111111111111111111111111111111111111
11111111111111111111111111111111111111111111111111111111111111111111111111111111111111111111111111111111111111111111111111111111
11111111111111111111111111111111111111111111111111111111111111111111111111111111111111111111111111111111111111111111111111111111
11111111111111111111111111111111111111111111111111111111111111111111111111111111111111111111111111111111111111111111111111111111
11111111111111111111111111111111111111111111111111111111111111111111111111111111111111111111111111111111111111111111111111111111
11111111111111111111111111111111111111111111111111111111111111111111111111111111111111111111111111111111111111111111111111111111
11222222222222222222222222222222222222222222222222222222222222222222222222222222222222222222221111111111111111111111111111111111
11222222222222222222222222222222222222222222222222222222222222222222222222222222222222222222220000000000000000000000000000011111
11222222222222220000000000011111111111111111111111111111111111111111111111111111111111111111100000000000000000000000000000011111
11222222222222220000000000011111111111111111111111111111111111111111111111111111111111111111100000000000000000000000000000011111
11222222222222220000000000011111111111111111111111111111111111111111111111111111111111111111100000000000000000000000000000011111
11222222222222220000000000011111111111111111111111111111111111111111111111111111111111111111100000000000000000000000000000011111
11222222222222220000000000011111111111111111111111111111111111111111111111111111111111111111100000000000000000000000000000011111
11222222222222220000000000011111111111111111111111111111111111111111111111111111111111111111100000000000000000000000000000011111
11222222222222220000000000011111111111111111111111111111111111111111111111111111111111111111100000000000000000000000000000011111
11222222222222220000000000011111111111111111111111111111111111111111111111111111111111111111100000000000000000000000000000011111
11222222222222220000000000011111111111111111111111111111111111111111111111111111111111111111100000000000000000000000000000011111
11222222222222220000000000011111111111111111111111111111111111111111111111111111111111111111100000000000000000000000000000011111
11222222222222220000000000011111111111111111111111111111111111111111111111111111111111111111100000000000000000000000000000011111
11222222222222220000000000011111111111111111111111111111111111111111111111111111111111111111100000000000000000000000000000011111
11222222222222220000000000011111111111111111111111111111111111111111111111111111111111111111100000000000000000000000000000011111
11222222222222220000000000011111111111111111111111111111111111111111111111111111111111111111100000000000000000000000000000011111
11222222222222220000000000011111111111111111111111111111111111111111111111111111111111111111100000000000000000000000000000011111
11222222222222220000000000011111111111111111111111111111111111111111111111111111111111111111100000000000000000000000000000011111
11222222222222220000000000011111111111111111111111111111111111111111111111111111111111111111100000000000000000000000000000011111
11222222222222221111111111111111111111111111111111111111111111111111111111111111111111111111100000000000000000000000000000011111
11222222222222221111111111111111111111111111111111111111111111111111111111111111111111111111100000000000000000000000000000011111
11222222222222221111111111111111111111111111111111111111111111111111111111111111111111111111100000000000000000000000000000011111
11222222222222221111111111111111111111111111111111111111111111111111111111111111111111111111100000000000000000000000000000011111
11222222222222221111111111111111111111111111111111111111111111111111111111111111111111111111100000000000000000000000000000011111
11222222222222221111111111111111111111111111111111111111111111111111111111111111111111111111100000000000000000000000000000011111
11222222222222221111111111111111111111111111111111111111111111111111111111111111111111111111111111111111111111111111111111111111
11222222222222221111111111111111111111111111111111111111111111111111111111111111111111111111111111111111111111111111111111111111
11222222222222221111111111111111111111111111111111111111111111111111111111111111111111111111111111111111111111111111111111111111
11222222222222221111111111111111111111111111111111111111111111111111111111111111111111111111111111111111111111111111111111111111
11222222222222221111111111111111111111111111111111111111111111111111111111111111111111111111111111111111111111111111111111111111
11222222222222221111111111111111111111111111111111111111111111111111111111111111111111111111111111111111111111111111111111111111
11222222222222221111111111111111111111111111111111111111111111111111111111111111111111111111111111111111111111111111111111111111
11222222222222222222222222222220000000000000000000000000000000000000000000000011111111111111111111111111111111111111111111111111
11222222222222222222222222222220000000000000000000000000000000000000000000000011111111111111111111111111111111111111111111111111
11222222222222222222222222222220000000000000000000000000000000000000000000000011111111111111111111111111111111111111111111111111
11222222222222222222222222222220000000000000000000000000000000000000000000000011111111111111111111111111111111111111111111111111
11222222222222222222222222222220000000000000000000000000000000000000000000000011111111111111111111111111111111111111111111111111
11222222222222222222222222222220000000000000000000000000000000000000000000000011111111111111111111111111111111111111111111111111
11222222222222222222222222222220000000000000000000000000000000000000000000000011111111111111111111111111111111111111111111111111
11222222222222222222222222222221111111111111111111111111111111111111111111111111111111111111111111111111111111111111111111111111
11222222222222222222222222222221111111111111111111111111111111111111111111111111111111111111111111111111111111111111111111111111
11222222222222222222222222222221111111111111111111111111111111111111111111111111111111111111111111111111111111111111111111111111
11222222222222222222222222222221111111111111111111111111111111111111111111111111111111111111111111111111111111111111111111111111
11222222222222222222222222222221111111111111111111111111111111111111111111111111111111111111111111111111111111111111111111111111
11222222222222222222222222222221111111111111111111111111111111111111111111111111111111111111111111111111111111111111111111111111
11222222222222222222222222222221111111111111111111111111111111111111111111111111111111111111111111111111111111111111111111111111
11222222222222222222222222222220000000000000000000000000000000000000000000000000000000111111111111111111111111111111111111111111
11222222222222221111111111111100000000000000000000000000000000000000000000000000000000111111111111111111111111111111111111111111
11222222222222221111111111111100000000000000000000000000000000000000000000000000000000111111111111111111111111111111111111111111
11222222222222221111111111111100000000000000000000000000000000000000000000000000000000111111111111111111111111111111111111111111
11222222222222221111111111111100000000000000000000000000000000000000000000000000000000111111111111111111111111111111111111111111
11222222222222221111111111111100000000000000000000000000000000000000000000000000000000111111111111111111111111111111111111111111
11222222222222221111111111111111111111111111111111111111111111111111111111111111111111111111111111111111111111111111111111111111
11222222222222221111111111111111111111111111111111111111111111111111111111111111111111111111111111111111111111111111111111111111
11222222222222221111111111111111111111111111111111111111111111111111111111111111111111111111111111111111111111111111111111111111
11222222222222221111111111111111111111111111111111111111111111111111111111111111111111111111111111111111111111111111111111111111
11222222222222221111111111111111111111111111111111111111111111111111111111111111111111111111111111111111111111111111111111111111
11222222222222221111111111111111111111111111111111111111111111111111111111111111111111111111111111111111111111111111111111111111
11222222222222221111111111111111111111111111111111111111111111111111111111111111111111111111111111111111111111111111111111111111
11222222222222221111111111111111111111111111111111111111111111111111111111111111111111111111111111111111111111111111111111111111
11222222222222221111111111111111111111111111111111111111111111111111111111111111111111111111111111111111111111111111111111111111
11222222222222221111111111111111111111111111111111111111111111111111111111111111111111111111111111111111111111111111111111111111
11222222222222221111111111111111111111111111111111111111111111111111111111111111111111111111111111111111111111111111111111111111
11222222222222221111111111111111111111111111111111111111111111111111111111111111111111111111111111111111111111111111111111111111
11222222222222221111111111111111111111111111111111111111111111111111111111111111111111111111111111111111111111111111111111111111
11222222222222221111111111111111111111111111111111111111111111111111111111111111111111111111111111111111111111111111111111111111
11222222222222221111111111111111111111111111111111111111111111111111111111111111111111111111111111111111111111111111111111111111
11222222222222221111111111111111111111111111111111111111111111111111111111111111111111111111111111111111111111111111111111111111
11222222222222221111111111111111111111111111111111111111111111111111111111111111111111111111111111111111111111111111111111111111
11222222222222221111111111111111111111111111111111111111111111111111111111111111111111111111111111111111111111111111111111111111
11222222222222221111111111111111111111111111111111111111111111111111111111111111111111111111111111111111111111111111111111111111
11222222222222222222222222222222222222222222222222222222222222211111111111111111111111111111111111111111111111111111111111111111
11111111111111122222222222222222222222222222222222222222222222211111111111111111111111111111111111111111111111111111111111111111
11111111111111122222222222222222222222222222222222222222222222222222222222222222222222222222222200000000000000000000011111111111
11111111111111120000000000000000000000000000000000011111111111222222222222222222222222222222222200000000000000000000011111111111
11111111111111120000000000000000000000000000000000011111111111222222222222222222222222222222222200000000000000000000011111111111
11111111111111120000000000000000000000000000000000011111111111222222222222222222222222222222222200000000000000000000011111111111
11111111111111120000000000000000000000000000000000011111111111222222222222222222222222222222222200000000000000000000011111111111
11111111111111120000000000000000000000000000000000011111111111222222222222222222222222222222222200000000000000000000011111111111
11111111111111120000000000000000000000000000000000011111111111222222222222222222222222222222222200000000000000000000011111111111
11111111111111120000000000000000000000000000000000011111111111222222222222222222222222222222222200000000000000000000011111111111
11111111111111121111111111111111111111111111111111111111111111222222222222222222222222222222222200000000000000000000011111111111
11111111111111121111111111111111111111111111111111111111111111222222222222222222222222222222222200000000000000000000011111111111
11111111111111121111111111111111111111111111111111111111111111222222222222222222222222222222222200000000000000000000011111111111
11111111111111121111111111111111111111111111111111111111111111222222222222222222222222222222222200000000000000000000011111111111
11111111111111121111111111111111111111111111111111111111111111222222222222222222222222222222222200000000000000000000011111111111
11111111111111121111111111111111111111111111111111111111111111000000000011111111111111111111111000000000000000000000011111111111
11111111111111120000000000000000000000000011111111111111111111000000000011111111111111111111111000000000000000000000011111111111
11111111111111100000000000000000000000000011111111111111111111000000000011111111111111111111111000000000000000000000011111111111
11111111111111100000000000000000000000000011111111111111111111000000000011111111111111111111111000000000000000000000011111111111
11111111111111100000000000000000000000000011111111111111111111000000000011111111111111111111111000000000000000000000011111111111
11111111111111100000000000000000000000000011111111111111111111000000000011111111111111111111111000000000000000000000011111111111
11111111111111100000000000000000000000000011111111111111111111000000000011111111111111111111111000000000000000000000011111111111
11111111111111100000000000000000000000000011111111111111111111000000000011111111111111111111111000000000000000000000011111111111
11111111111111100000000000000000000000000011111111111111111111000000000011111111111111111111111000000000000000000000011111111111
11111111111111100000000000000000000000000011111111111111111111000000000011111111111111111111111000000000000000000000011111111111
11111111111111100000000000000000000000000011111111111111111111000000000011111111111111111111111000000000000000000000011111111111
11111111111111100000000000000000000000000011111111111111111111000000000011111111111111111111111000000000000000000000011111111111
11111111111111111111111111111111111111111111111111111111111111000000000011111111111111111111111000000000000000000000011111111111
11111111111111111111111111111111111111111111111111111111111111000000000011111111111111111111111000000000000000000000011111111111
11111111111111111111111111111111111111111111111111111111111111000000000011111111111111111111111000000000000000000000011111111111
11111111111111111111111111111111111111111111111111111111111111000000000011111111111111111111111000000000000000000000011111111111
11111111111111111111111111111111111111111111111111111111111111000000000011111111111111111111111000000000000000000000011111111111
11111111111111111111111111111111111111111111111111111111111111000000000011111111111111111111111000000000000000000000011111111111
11111111111111111111111111111111111111111111111111111111111111000000000011111111111111111111111000000000000000000000011111111111
11111111111111111111111111111111111111111111111111111111111111000000000011111111111111111111111111111111111111111111111111111111
11111111111111111111111111111111111111111111111111111111111111000000000011111111111111111111111111111111111111111111111111111111
11111111111111111111111111111111111111111111111111111111111111000000000011111111111111111111111111111111111111111111111111111111
11111111111111111111111111111111111111111111111111111111111111000000000011111111111111111111111111111111111111111111111111111111
11111111111111111111111111111111111111111111111111111111111111111111111111111111111111111111111111111111111111111111111111111111
11111111111111111111111111111111111111111111111111111111111111111111111111111111111111111111111111111111111111111111111111111111
11111111111111111111111111111111111111111111111111111111111111111111111111111111111111111111111111111111111111111111111111111111
11111111111111111111111111111111111111111111111111111111111111111111111111111111111111111111111111111111111111111111111111111111
11111111111111111111111111111111111111111111111111111111111111111111111111111111111111111111111111111111111111111111111111111111
11111111111111111111111111111111111111111111111111111111111111111111111111111111111111111111111111111111111111111111111111111111
11111111111111111111111111111111111111111111111111111111111111111111111111111111111111111111111111111111111111111111111111111111
