11111111111111111111111111111111111111111111111111111111111111111111111111111111111111111111111111111111111111111111111111111111
11111111111111111111111111111111111111111111111111111111111111111111111111111111111111111111111111111111111111111111111111111111
11111111111111111111111111111111111111111111111111111111111111111111111111111111111111111111111111111111111111111111111111111111
11111111111111111111111111111111111111111111111111111111111111111111111111111111111111111111111111111111111111111111111111111111
11111111111111111111111111111111111111111111111111111111111111111111111111111111111111111111111111111111111111111111111111111111
11111111111111111111111111111111111111111111111111111111111111111111111111111111111111111111111111111111111111111111111111111111
11111111111111111111111111111111111111111111111111111111111111111111111111111111111111111111111111111111111111111111111111111111
11111111111111111111111111111111111111111111111111111111111111111111111111111111111111111111111111111111111111111111111111111111
11111111111111111111111111111111111111111111111111111111111111111111111111111111111111111111111111111111111111111111111111111111
11111111111111111111111111111111111111111111111111111111111111111111111111111111111111111111111111111111111111111111111111111111
11111111111111111111111111111111111111111111111111111111111111111111111111111111111111111111111111111111111111111111111111111111
11111111111111111111111111111111111111111111111111111111111111111111111111111111111111111111111111111111111111111111111111111111
11000000000000000000000000011111111111111111111111111111111111111111111111111111111111111111111111111111111111111111111111111111
11000000000000000000000000011111111111111111111111111111111111111111111111111111111111111111100000000000000000000000000000011111
11000000000000000000000000011111111111111111111111111111111111111111111111111111111111111111100000000000000000000000000000011111
11000000000000000000000000011111111111111111111111111111111111111111111111111111111111111111100000000000000000000000000000011111
11000000000000000000000000011111111111111111111111111111111111111111111111111111111111111111100000000000000000000000000000011111
11000000000000000000000000011111111111111111111111111111111111111111111111111111111111111111100000000000000000000000000000011111
11000000000000000000000000011111111111111111111111111111111111111111111111111111111111111111100000000000000000000000000000011111
11000000000000000000000000011111111111111111111111111111111111111111111111111111111111111111100000000000000000000000000000011111
11000000000000000000000000011111111111111111111111111111111111111111111111111111111111111111100000000000000000000000000000011111
11000000000000000000000000011111111111111111111111111111111111111111111111111111111111111111100000000000000000000000000000011111
11000000000000000000000000011111111111111111111111111111111111111111111111111111111111111111100000000000000000000000000000011111
11000000000000000000000000011111111111111111111111111111111111111111111111111111111111111111100000000000000000000000000000011111
11000000000000000000000000011111111111111111111111111111111111111111111111111111111111111111100000000000000000000000000000011111
11000000000000000000000000011111111111111111111111111111111111111111111111111111111111111111100000000000000000000000000000011111
11000000000000000000000000011111111111111111111111111111111111111111111111111111111111111111100000000000000000000000000000011111
11000000000000000000000000011111111111111111111111111111111111111111111111111111111111111111100000000000000000000000000000011111
11000000000000000000000000011111111111111111111111111111111111111111111111111111111111111111100000000000000000000000000000011111
11000000000000000000000000011111111111111111111111111111111111111111111111111111111111111111100000000000000000000000000000011111
11000000000000000000000000011111111111111111111111111111111111111111111111111111111111111111100000000000000000000000000000011111
11111111111111111111111111111111111111111111111111111111111111111111111111111111111111111111100000000000000000000000000000011111
11111111111111111111111111111111111111111111111111111111111111111111111111111111111111111111100000000000000000000000000000011111
11111111111111111111111111111111111111111111111111111111111111111111111111111111111111111111100000000000000000000000000000011111
11111111111111111111111111111111111111111111111111111111111111111111111111111111111111111111100000000000000000000000000000011111
11111111111111111111111111111111111111111111111111111111111111111111111111111111111111111111100000000000000000000000000000011111
11111111111111111111111111111111111111111111111111111111111111111111111111111111111111111111100000000000000000000000000000011111
11111111111111111111111111111111111111111111111111111111111111111111111111111111111111111111111111111111111111111111111111111111
11111111111111111111111111111111111111111111111111111111111111111111111111111111111111111111111111111111111111111111111111111111
11111111111111111111111111111111111111111111111111111111111111111111111111111111111111111111111111111111111111111111111111111111
11111111111111111111111111111111111111111111111111111111111111111111111111111111111111111111111111111111111111111111111111111111
11111111111111111111111111111111111111111111111111111111111111111111111111111111111111111111111111111111111111111111111111111111
11111111111111111111111111111111111111111111111111111111111111111111111111111111111111111111111111111111111111111111111111111111
11111111111111111111111111111111111111111111111111111111111111111111111111111111111111111111111111111111111111111111111111111111
11100000000000000000000000000000000000000000000000000000000000000000000000000011111111111111111111111111111111111111111111111111
11100000000000000000000000000000000000000000000000000000000000000000000000000011111111111111111111111111111111111111111111111111
11100000000000000000000000000000000000000000000000000000000000000000000000000011111111111111111111111111111111111111111111111111
11100000000000000000000000000000000000000000000000000000000000000000000000000011111111111111111111111111111111111111111111111111
11100000000000000000000000000000000000000000000000000000000000000000000000000011111111111111111111111111111111111111111111111111
11100000000000000000000000000000000000000000000000000000000000000000000000000011111111111111111111111111111111111111111111111111
11100000000000000000000000000000000000000000000000000000000000000000000000000011111111111111111111111111111111111111111111111111
11111111111111111111111111111111111111111111111111111111111111111111111111111111111111111111111111111111111111111111111111111111
11111111111111111111111111111111111111111111111111111111111111111111111111111111111111111111111111111111111111111111111111111111
11111111111111111111111111111111111111111111111111111111111111111111111111111111111111111111111111111111111111111111111111111111
11111111111111111111111111111111111111111111111111111111111111111111111111111111111111111111111111111111111111111111111111111111
11111111111111111111111111111111111111111111111111111111111111111111111111111111111111111111111111111111111111111111111111111111
11111111111111111111111111111111111111111111111111111111111111111111111111111111111111111111111111111111111111111111111111111111
11111111111111111111111111111111111111111111111111111111111111111111111111111111111111111111111111111111111111111111111111111111
11111111111111111111111111111100000000000000000000000000000000000000000000000000000000111111111111111111111111111111111111111111
11111111111111111111111111111100000000000000000000000000000000000000000000000000000000111111111111111111111111111111111111111111
11111111111111111111111111111100000000000000000000000000000000000000000000000000000000111111111111111111111111111111111111111111
11111111111111111111111111111100000000000000000000000000000000000000000000000000000000111111111111111111111111111111111111111111
11111111111111111111111111111100000000000000000000000000000000000000000000000000000000111111111111111111111111111111111111111111
11111111111111111111111111111100000000000000000000000000000000000000000000000000000000111111111111111111111111111111111111111111
11111111111111111111111111111111111111111111111111111111111111111111111111111111111111111111111111111111111111111111111111111111
11111111111111111111111111111111111111111111111111111111111111111111111111111111111111111111111111111111111111111111111111111111
11111111111111111111111111111111111111111111111111111111111111111111111111111111111111111111111111111111111111111111111111111111
11111111111111111111111111111111111111111111111111111111111111111111111111111111111111111111111111111111111111111111111111111111
11111111111111111111111111111111111111111111111111111111111111111111111111111111111111111111111111111111111111111111111111111111
11111111111111111111111111111111111111111111111111111111111111111111111111111111111111111111111111111111111111111111111111111111
11111111111111111111111111111111111111111111111111111111111111111111111111111111111111111111111111111111111111111111111111111111
11111111111111111111111111111111111111111111111111111111111111111111111111111111111111111111111111111111111111111111111111111111
11111111111111111111111111111111111111111111111111111111111111111111111111111111111111111111111111111111111111111111111111111111
11111111111111111111111111111111111111111111111111111111111111111111111111111111111111111111111111111111111111111111111111111111
11111111111111111111111111111111111111111111111111111111111111111111111111111111111111111111111111111111111111111111111111111111
11111111111111111111111111111111111111111111111111111111111111111111111111111111111111111111111111111111111111111111111111111111
11111111111111111111111111111111111111111111111111111111111111111111111111111111111111111111111111111111111111111111111111111111
11111111111111111111111111111111111111111111111111111111111111111111111111111111111111111111111111111111111111111111111111111111
11111111111111111111111111111111111111111111111111111111111111111111111111111111111111111111111111111111111111111111111111111111
11111111111111111111111111111111111111111111111111111111111111111111111111111111111111111111111111111111111111111111111111111111
11111111111111111111111111111111111111111111111111111111111111111111111111111111111111111111111111111111111111111111111111111111
11111111111111111111111111111111111111111111111111111111111111111111111111111111111111111111111111111111111111111111111111111111
11111111111111111111111111111111111111111111111111111111111111111111111111111111111111111111111111111111111111111111111111111111
11111111111111100000000000000000000000000000000000011111111111111111111111111111111111111111111111111111111111111111111111111111
11111111111111100000000000000000000000000000000000011111111111111111111111111111111111111111111111111111111111111111111111111111
11111111111111100000000000000000000000000000000000011111111111111111111111111111111111111111111000000000000000000000011111111111
11111111111111100000000000000000000000000000000000011111111111111111111111111111111111111111111000000000000000000000011111111111
11111111111111100000000000000000000000000000000000011111111111111111111111111111111111111111111000000000000000000000011111111111
11111111111111100000000000000000000000000000000000011111111111111111111111111111111111111111111000000000000000000000011111111111
11111111111111100000000000000000000000000000000000011111111111111111111111111111111111111111111000000000000000000000011111111111
11111111111111100000000000000000000000000000000000011111111111111111111111111111111111111111111000000000000000000000011111111111
11111111111111100000000000000000000000000000000000011111111111111111111111111111111111111111111000000000000000000000011111111111
11111111111111100000000000000000000000000000000000011111111111111111111111111111111111111111111000000000000000000000011111111111
11111111111111111111111111111111111111111111111111111111111111111111111111111111111111111111111000000000000000000000011111111111
11111111111111111111111111111111111111111111111111111111111111111111111111111111111111111111111000000000000000000000011111111111
11111111111111111111111111111111111111111111111111111111111111111111111111111111111111111111111000000000000000000000011111111111
11111111111111111111111111111111111111111111111111111111111111111111111111111111111111111111111000000000000000000000011111111111
11111111111111111111111111111111111111111111111111111111111111000000000011111111111111111111111000000000000000000000011111111111
11111111111111111111111111111111111111111111111111111111111111000000000011111111111111111111111000000000000000000000011111111111
11111111111111100000000000000000000000000011111111111111111111000000000011111111111111111111111000000000000000000000011111111111
11111111111111100000000000000000000000000011111111111111111111000000000011111111111111111111111000000000000000000000011111111111
11111111111111100000000000000000000000000011111111111111111111000000000011111111111111111111111000000000000000000000011111111111
11111111111111100000000000000000000000000011111111111111111111000000000011111111111111111111111000000000000000000000011111111111
11111111111111100000000000000000000000000011111111111111111111000000000011111111111111111111111000000000000000000000011111111111
11111111111111100000000000000000000000000011111111111111111111000000000011111111111111111111111000000000000000000000011111111111
11111111111111100000000000000000000000000011111111111111111111000000000011111111111111111111111000000000000000000000011111111111
11111111111111100000000000000000000000000011111111111111111111000000000011111111111111111111111000000000000000000000011111111111
11111111111111100000000000000000000000000011111111111111111111000000000011111111111111111111111000000000000000000000011111111111
11111111111111100000000000000000000000000011111111111111111111000000000011111111111111111111111000000000000000000000011111111111
11111111111111100000000000000000000000000011111111111111111111000000000011111111111111111111111000000000000000000000011111111111
11111111111111111111111111111111111111111111111111111111111111000000000011111111111111111111111000000000000000000000011111111111
11111111111111111111111111111111111111111111111111111111111111000000000011111111111111111111111000000000000000000000011111111111
11111111111111111111111111111111111111111111111111111111111111000000000011111111111111111111111000000000000000000000011111111111
11111111111111111111111111111111111111111111111111111111111111000000000011111111111111111111111000000000000000000000011111111111
11111111111111111111111111111111111111111111111111111111111111000000000011111111111111111111111000000000000000000000011111111111
11111111111111111111111111111111111111111111111111111111111111000000000011111111111111111111111000000000000000000000011111111111
11111111111111111111111111111111111111111111111111111111111111000000000011111111111111111111111000000000000000000000011111111111
11111111111111111111111111111111111111111111111111111111111111000000000011111111111111111111111111111111111111111111111111111111
11111111111111111111111111111111111111111111111111111111111111000000000011111111111111111111111111111111111111111111111111111111
11111111111111111111111111111111111111111111111111111111111111000000000011111111111111111111111111111111111111111111111111111111
11111111111111111111111111111111111111111111111111111111111111000000000011111111111111111111111111111111111111111111111111111111
11111111111111111111111111111111111111111111111111111111111111111111111111111111111111111111111111111111111111111111111111111111
11111111111111111111111111111111111111111111111111111111111111111111111111111111111111111111111111111111111111111111111111111111
11111111111111111111111111111111111111111111111111111111111111111111111111111111111111111111111111111111111111111111111111111111
11111111111111111111111111111111111111111111111111111111111111111111111111111111111111111111111111111111111111111111111111111111
11111111111111111111111111111111111111111111111111111111111111111111111111111111111111111111111111111111111111111111111111111111
11111111111111111111111111111111111111111111111111111111111111111111111111111111111111111111111111111111111111111111111111111111
11111111111111111111111111111111111111111111111111111111111111111111111111111111111111111111111111111111111111111111111111111111
